
NoneType = type(None)
TypeType = type
ObjectType = object
IntType = int
LongType = long
FloatType = float
BooleanType = bool
try:
	ComplexType = complex
except NameError:
	pass
StringType = str
try:
	UnicodeType = unicode
	StringTypes = (StringType, UnicodeType)
except NameError:
	StringTypes = (StringType,)
BufferType = buffer
TupleType = tuple
ListType = list
DictType = DictionaryType = dict
def _f(): pass
FunctionType = type(_f)
LambdaType = type(lambda: None)
CodeType = type(_f.func_code)
def _g():
	yield 1
GeneratorType = type(_g())
class _C:
	def _m(self): pass
ClassType = type(_C)
UnboundMethodType = type(_C._m)
_x = _C()
InstanceType = type(_x)
MethodType = type(_x._m)
BuiltinFunctionType = type(len)
BuiltinMethodType = type([].app